WWWWWWWWWWWWWWWWWWW
WCOOOOOOOOOOOOOOOCW
WOWOWWWWWOWWWWWOWOW
WOWOOOOOOOOOOOOOWOW
WOWOWOWWWWWWWOWOWOW
WOWOWOOOOOOOOOWOWOW
WOOOWOWOOOOOWOWOOOW
WOWOWOWOOOOOWOWOWOW
WOWOWOWOOOOOWOWOWOW
WOWOOOOOOOOOOOOOWOW
WOWOWWWWWWWWWWWOWOW
WCOOOOOOOOOOOOOOOCW
WWWWWWWWWWWWWWWWWWW