WWWWWWWWWWWWWWWWWWW
WCOOOOOOOOOOOOOOOCW
WOWOWOWOWOWOWOWOWOW
WOOOOOOOOOOOOOOOOOW
WOWOWOWOWOWOWOWOWOW
WOWOWOOOOOOOOOWOWOW
WOWOWOWOWOWOWOWOWOW
WOOOOOOOOOOOOOOOOOW
WOWOWCWOOOOOWCWOWOW
WOWOWWWOOOOOWWWOWOW
WOWOWOWOWOWOWOWOWOW
WCOOOOOOOOOOOOOOOCW
WWWWWWWWWWWWWWWWWWW