WWWWWWWWWWWWWWWWWWW
WCOOOOOOOOOOOOOOOCW
WOWOWWOWWOWWOWWOWOW
WOOOOOOOOOOOOOOOOOW
WOWOOWWWWOWWWOWOWOW
WOWOOOOOOOOOOOOOWOW
WOOOWOOOWWWOOOOOOOW
WOWOOOOOOOOOOOOOWOW
WOWOWWWOWOWOWWWOWOW
WOOOWOOOOOOOOOWOOOW
WOWOWOOOOWOOOOWOWOW
WCWOOOOOOOOOOOOOWCW
WWWWWWWWWWWWWWWWWWW